17 20
1 1
15 18
********************
*S******************
*     * * * * *   **
* ***** * *** * ** *
* * *       *      *
* * *** * *** **** *
*   *   * *     *  *
*** * * * *** *** **
*   *** * * * * *  *
*** * *** * *** * **
*            *    **
********** * * **  *
*                 **
* ****** ** ** *****
*    *    * *      *
******************X*
********************