11 9
1 1
9 7
*********
*S*******
*     * *
* ***** *
* * *   *
* * *** *
*   *   *
*** * * *
*     * *
*******X*
*********
