15 20
1 0
11 19
********************
S *       *        *
* * *** **** *** ***
* * * *        * * *
* *** **** ** ** * *
* *      * *       *
* ****** * *** *** *
*        *     * * *
******* ** ***** * *
*        *       ***
* *** ******* **** *
*** * *        *   X
* * * * **** ***** *
*          *       *
********************