15 16
1 0
9 15
****************
S *       *    *
* * *** **** ***
* * * *        *
* *** **** ** **
* *      * *   *
* ****** * *** *
*        *     *
******* ** *****
*        *     X
* *** ******* **
*** * *        *
* * * * **** ***
*          *   *
****************