5 5
0 1
4 3
*S***
* ***
*   *
*** *
***X*